20 8
001 001 001 001 001 001 001 001 001 001 001 001 001 001 001 001 001 001 001 001 
001 000 000 050 050 050 001 050 000 001 050 001 050 000 050 101 050 001 050 001 
001 000 120 050 050 050 101 050 000 101 050 101 050 000 050 001 050 000 052 109 
001 001 102 001 001 001 001 001 102 001 001 001 102 001 001 001 001 001 001 001 
001 000 000 055 050 050 001 050 000 001 050 001 050 000 050 001 050 001 050 001 
001 000 000 055 050 050 101 050 000 101 050 101 050 000 050 101 050 000 050 109 
001 000 000 055 050 050 001 050 000 001 050 001 050 000 050 001 050 001 052 001 
001 001 001 001 001 001 001 001 001 001 001 001 001 001 001 001 001 001 001 001 
